1111111111111111111111111111111111
10P000C0C0C0C0C0C0C0C0C1C0C0C0C001
101001001000101C0C0100C10C0C0CC011
1010010100C000C0C0C000C1C000010111
100X0000100010000010010000C0111111
1000010C0C0C00C010100100C000110001
10C00C0C0C0C0C00001001000000100001
10001CCCCCC0111111110100000X100001
1C0C0C01000010C0C0C100100C00111111
10100100100010C000C1010C0C0C0C00C1
11001011110010CC0C0100C0C111001111
10C0C0C0C0C0C0C0C0C0C00C0C0C0C0E11
1111111111111111111111111111111111