1111111111111111111111111111111111
1000001000100000C000111000C0000001
101001001000101C0C0100100000001011
1010010100C00000101000C00000010111
10100100100010100010010000C0010101
101001E00000001010100100C000010101
1010010010101010001001000000010101
1C0000C000000000000001000000000001
10100101000000000P1100100C00001011
1010010010001010001001000C0C010101
101001001000101C0C0100100000001011
1010010100C00000101000C00000010111
101001001000101C0C0100100000001011
1010010100C00000101000C00000010111
10100100100010100010010000C0010101
10100100100010100010010000C0010101
1111111111111111111111111111111111