1111111111111111111111111111111111
1E0000000010000C00000C000000000001
1010010100000010101001000000010101
1010010010101010001001000000010101
1P00C0000C00C0000001110000000000C1
1010010100000000101001000000010101
1010010010001010001001000000010101
1010010100000000101000000000010101
1010010C100010100010010000C0010101
1111111111111111111111111111111111