1111111111111111111111111111111
10011111C011C001000C01000011111
1100000000011101001000011000111
110111011C00010000001101C010111
110000000000C000101110011000C11
1010001111110100110010001111011
1000100C00011110000000110101111
10C01101110000C1101000P00000C11
1111111111011111111111111111111
1000000000000000000000000000E01
1111111111111111111111111111111